35 16
16 2
19 7,32 10,7 10
20 2,8 4,33 4,4 15,29 10
-----------------------------------
========H==========----------------
--------HTTTTTTTTTTTTTTT-----------
--------H------===H-----========H==
--------H------===H-------------H--
--------H------===H-------------H--
===H=====------=============H======
---H------------------------H------
---H------------------------H------
===========H================H------
-----------H----------------H------
-----------H-TTTTTTTTTTTTTTTH------
-----H========--------------======H
-----H----------------------------H
===================================
AAAAAAAAAAAAAAAAAAAAAAAAAAAAAAAAAAA