50 11
5 2
15 2,6 9
10 2,49 2,1 9
--------------------------------------------------
--------------------------------------------------
===H=====---------------------------------HTTTTTTT
---H--------------------------------------H-------
---H-----TTTTT==H==TTTTT------------------H-------
---H------------H-------------------------H-------
---H-----=======H=======H======-----------H-------
---H--------------------H-----==-------H==--------
---H--------------------H-----===----H==----------
==================================================
AAAAAAAAAAAAAAAAAAAAAAAAAAAAAAAAAAAAAAAAAAAAAAAAAA