8 6
--------
-----X--
--------
--------
--------
XXXXXXXX