8 7
1 2
6 2,
7 2,
TTTH----
---H----
---H----
===H----
---H----
========
AAAAAAAA