32 16
6 2
2 10,30 14,18 5
14 9,22 2,0 10
--------------------------------
--------------------------------
===-----------------=====H======
--==---------------==----H------
---==-------------===----H------
---===----------=====----H------
==H====--------======H==========
--H--===-----===-----H----------
--H----===H===-------H----------
H===H-----H--------==H==H====---
H---H-------------------H-------
H---H=========H=========H=====H=
H-------------H---------------H-
H-------------H---------------H-
================================
AAAAAAAAAAAAAAAAAAAAAAAAAAAAAAAA