9 8
1 2
6 2,
7 2,
--TTHTTTT
----H----
----H----
====H----
----H----
----H----
=========
AAAAAAAAA