8 6
1 1
5 1,
7 1,
TTTH----
---H----
---H----
===H----
---H----
AAAAAAAA